 50*20
##################################################
#                                               T#
#        O                                       #
#                                                #
#                                                #
#                                                #
#                                                #
#                                                #
# DDDDDDDDDDDDDDDDDDDDDDDDDD   DDDDDDDDDDDDDDDDDD#
#                                                #
#                                                #
#                                                #
#                                                #
#                                                #
#                                                #
#                G                         G     #
#                                                #
#                                                #
#                                                #
#                                                #
##################################################